11111111111111111111111111111111111111111111111111
100000000000000000000000000001
100000000E0000001
100000P000000C111
10000011100000111
11111111111111111