11111111111111111
10000000000000001
100000000E0000001

10000011100000111
11111111111111111