1111111111111
100P0000000C1
1000111110001
1000110000001
100011E000001
1000110000001
1000110001001
1111111111111