1111111111111
10000000000C1
1000111110001
1000110000001
100011E000001
10P000000C001
1000000001001
100C0C0001001
10000CC001001
1000000001001
1111111111111