1111111111111
10000010000C1
1000111110001
1000110000001
10P0110E00001
1000110000001
1111111111111